{
Rows: 180
Cols: 16
Tilemap: Resources/Tiles/Tilemap.png
EndZone: 232 2704 8 32
Music: Underworld
}

2222222222222222
2222222222222222
2222111111112222
2111108000802222
2500009000900022
260000A000A00022
2200002111100022
2211112287700022
2200000090000022
22000000A0000022
2200001111111122
22B0007700000022
22A0000000000022
2211111111000022
2210000000000022
0002000000000000
0002010000000000
2222000011111111
22220000000H00D2
22220000000H00E2
22220000000H0022
00022B00000I0000
00022A0000000000
0001111200000000
0000002200000000
0000001111200000
0000000002200000
0000000001111200
0000000007702200
0000000000001111
0000000000000002
00000000B2200002
00000000A2200002
0000021111000002
0000022077000002
0021111000000002
0022800000000002
1111900000021111
0770C00000022080
0000A00021111090
00000000220000C0
00000211110000A0
0000022000000000
0021111000000000
0022000000000000
0000000000000000
0000000000000000
00000LL00LL00000
0000000000000000
0000000000000000
0000000LL00LLLL0
0000000000000000
0000000000000000
000LLLL00LLLL000
000H000000000000
000H000000000000
000I0LLLLL000000
0000000000000000
0000000000000000
000000L000LL0000
0000000000000000
0000000000000000
00000LL00LL00000
0000000000000000
0000000000000000
0000000LL00LLLL0
0000000000000000
0000000000000000
000LLLL00LLLL000
000H000000000000
000H000000000000
000I0LLLLL000000
0000000000000000
0000000000000000
000000L000LL0000
2222000220000022
2222LL0220000022
222200022000LL22
2222000220000022
00020LL220000000
00020H0220000000
00L20H0220000000
20020H02PPPPPPPP
20020I00770000PP
2L020000000000PP
20020000000000PP
200200000000000P
20L200000PPPP00P
200200000000000P
2002PPPP0000000P
2L0200000000000P
200200000000000P
20020000PPPP000P
20L200000077000P
200D0000000000PP
200EPPPP000000PP
2L0200H0000000PP
200200H0000000PP
200200I00PPPP022
20L2007000000022
2002000000000022
20020PPPP00000PP
2L020000000000PP
20020000000000PP
2002000000PPPPPP
200111120000000P
200000220000000P
200000111111110P
20000007700D200P
20000000000E2000
2000000000000000
2000000000000000
200000LLLL0LLLLL
000000H000000H00
000000H000000H00
000000I0L0000H00
0000007000000I00
00000000L0000700
0000000000000000
1111111100000000
0000000000000000
0000000000000000
LL20020020020000
0020020020020000
0020020020020000
002LL20020020M00
00J00000J0000M00
00J00000K0000M00
00J0000070000M00
00K0000000000000
0070000000000000
00000M00M00M0000
0000000000000000
00M0000000000000
0000000000000000
0000000000000000
0000LLLL00000000
0000000000000000
0000000MMMM20000
0000000000220000
MMMM200000111111
0002200000800000
000MMMM000900000
0000000000A00000
000000MMMM220000
0000000022220000
00000000MMMM0000
0000000007700000
0000000000000000
111111110000MMMM
0000002200000000
0000002200000000
0000002211111111
000000J00000000M
000000J000000LLM
000000K00000000M
000000700000000M
00000000000LL00M
0000B0000000000M
MMMMA00MMMM0000M
MMMMMMMM7700000M
MM00000N0000000M
M000000O0000000M
M0L0000O0000000M
M000000N0000000M
MM0M000000000000
MM0M000000000000
M00MMMMMMMMMMMMM
M000MMMMMMMMMMMM
M000000N000N003M
M000000O000O004M
M000000O000O0MMM
MMMM000NMMMN0MMM
MMMMMMMMMMMNMMMM
0000MMMM0000MMMM
0000007700000000
0000000000000000
0000000000000000
0000000000000000
0000000000000000
