{
Rows: 15
Cols: 16
Tilemap: Resources/Tiles/Tilemap.png
EndZone: 0 0 0 0
Music: 
}

0000000000000000
QQQQQQQQQQQQSSSS
QUUUQQQQQQQQUUQQ
Q000000000000QQQ
Q000000000000QQQ
Q00000000000003Q
Q00000000000004Q
Q00000000000000Q
Q00000000000000Q
Q00000000000000Q
Q00000000000000Q
Q00000000000000Q
Q00000000000000Q
QQQQQQQQQQQQQQQQ
QQQQQQQQQQQQQQQQ