{
Rows: 15
Cols: 16
Tilemap: Resources/Tiles/Tilemap.png
EndZone: 0 0 0 0
Music: Boss
}

TTTTTTTTTTTTTTTT
TTTTTTTTTTTTTTTT
T0000000000000TT
T0000000000000TT
TRRR000RR001111T
T00000000000003T
T00000000000004T
TRR000000000RRTT
T00000000000000T
T00000000000000T
T100000000000RRT
T00000000000000T
T00000000000000T
TTTTTTTTTTTTTTTT
TTTTTTTTTTTTTTTT